NO      textures/fox.xpm
SO    textures/cat.xpm
WE textures/dog.xpm
EA              textures/mouse.xpm

F 220,100,A21
C 255,255,255

11111111111111111111111111
10000000000000000000100001
10000000000000000000100001
1000000000000000E000100001
10000000000000000000100001
10000000010000000000000001
10000000000000000000000001
10000000000000000000000001
11111111111111111111111111
