
SO textures/fox.xpm

NO  textures/cat.xpm
C 204,255,255

WE textures/dog.xpm

F 32,32,32                         

                 



EA textures/mouse.xpm




                                                   

11111111111111111111111111111111111111111111111111111111111111111111111111111111
100000000000000000000000000000000000000000000000000000000000000000000000000001111111
1000000000000000000000000000000000100000000000000000000011100000000000000000000011111
1000010000000000000000110000000000000000000000000000000111000010000000000011110011111
10000000001001000000000000000000000000000000000000000000011100000000000000001111001
1000000000100100000000010001000000001111111100000000000001110000011111111111111111
1000000000000000000000010000000000001111111100000000000000000001110000000000000011
10000000000000000000000100010000000000000000000000000000100000111111111111111111111
1000010000000000000000010S000000000000000000000000000100100000000000000000000000001
10000100000000000000000100010000000000000000000000000100100000001111111111111111111
10000000000000000000000100000000000000000011111000000100100000000000000011111111111
1000000000000000000000010001000000000000000000000000010010000000000000000000000000011111
100000000000000000000001000000000000000000000000000001111000000000000000000011111111
111111111111111111111111111111111111111111111111111111111111111111111111111111111111111111
