


NO textures/Portal.xpm
WE textures/containerWindow.xpm
SO textures/Companion.xpm
EA textures/DoorBottom.xpm

F 12,115,43
C 63,17,117

1111111111111111111111111111111111111111111111111111111111111111111111111111111
10000000000000000000000000000000000000000000000000000000000000000000000000000000111
10000000000000000000000000000000001000000000000000000000000000000000000000000000011111
10N0010000000000000000100000000000000000000000000000000000000001000000000001111
1000000000100000000000001000000000000000000000000000000000000000000000000001111
100000000010000000000001000000000000000000000000000000000000000001111111111
10000000000000000000000100000000000000000000000000000000000000000111000000011
1000000000000000000000010000000000000000000000000000000001
1000010000000000000000010000000000000000000000000000000000000000001
1000010000000000000000010000000000000000000000000000000001111111111111111111
100000000000000000000001000000000000000000000000000000000000000000001
1000000000000000000000010000000000000000000000000000000000000000011111
10000000000000000000000100000000000000000000000000000000000000011111111
11111111111111111111111111111111111111111111111111111111111111111111111111