

NO textures/MET_VNT2.xpm
WE textures/METAL3.xpm
SO textures/METTRIA1.xpm
EA textures/test.xpm

F 32,32,32
C 204,255,255

1111111111111111111111111111111111111111111111111111111111111111111111111111111
1000000000000000000000000000000000000000000000000000000000000000000000000000011111111
1000000000000000000000000000000000100000000000000000000000000000000000000000000001111
10N0010000000000000000100000000000000000000000000000000000000001000000000001111001
1000000000100000000000001000000000000000000000000000000000000000000000000001111001
1000000000100000000000010000000000000000000000000000000000000000011111111111111111
1000000000000000000000010000000000000000000000000000000000000001110000000000000011
1000000000000000000000010000000000000000000000000000000000000111111111111111111111
10000100000000000000000100000000000000000000000000000000000000000000000000000000001
10000100000000000000000100000000000000000000000000000000000000001111111111111111111
10000000000000000000000100000000000000000011111000000000000000000000000011111111111
100000000000000000000001000000000000000000000000000000000000000000000000000000011111
100000000000000000000001000000000000000000000000000000000000000000000000000011111111
1111111111111111111111111111111111111111111111111111111111111111111111111111111111111111111