


NO textures/wall_2.xpm
WE textures/wall_2.xpm
SO textures/wall_2.xpm
EA textures/wall_2.xpm

F 33,33,33
C 135,206,235

1111111111111111111111111111111111111111111111111111111111111111111111111111111
10000000000000000000000000000000000000000000000000000000000000000000000000000000111
10000000000000000000000000000000001000000000000000000000000000000000000000000000011111
10N0010000000000000000100000000000000000000000000000000000000001000000000000000000000000000001111
10000000001000000000000010000000000000000000000000000000000000000000000000000000000000000000001
1000000000100000000000010000000000000000000000000000000000000000000000000000000000000000000001
1000000000000000000000010000000000000000000000000000000000000000000000000000000000000000000001
1000000000000000000000010000000000000000000000000000000000000000000000000000000000000000000001
1000010000000000000000010000000000000000000000000000000000000000000000000000000000000000000001
1000010000000000000000010000000000000000000000000000000000000000000000000000000000000000000001
1000000000000000000000010000000000000000000000000000000000000000000000000000000000000000000001
1000000000000000000000010000000000000000000000000000000000000000000000000000000000000000000001
1000000000000000000000010000000000000000000000000000000000000000000000000000000000000000000001
11111111111111111111111111111111111111111111111111111111111111111111111111