

NO textures/okcat.xpm
WE textures/okchien.xpm
SO textures/okrenard(1).xpm
EA textures/test.xpm

F 32,32,32
C 204,255,255

1111111111111111111111111111111111111111111111111111111111111111111111111111111
1000000000000000000000000000000000000000000000000000000000000000000000000000011111111
100000000000000000000000000000000010000000000000000000001110000000000000000000001111
10E0010000000000000000110000000000000000000000000000000011100001000000000001111001
10000000001001000000000000000000000000000000000000000000011100000000000000001111001
1000000000100100000000010001000000001111111100000000000001110000011111111111111111
1000000000000000000000010000000000001111111100000000000000000001110000000000000011
10000000000000000000000100010000000000000000000000000000100000111111111111111111111
10000100000000000000000100000000000000000000000000000100100000000000000000000000001
10000100000000000000000100010000000000000000000000000100100000001111111111111111111
10000000000000000000000100000000000000000011111000000100100000000000000011111111111
100000000000000000000001000100000000000000000000000001001000000000000000000000011111
100000000000000000000001000000000000000000000000000001111000000000000000000011111111
1111111111111111111111111111111111111111111111111111111111111111111111111111111111111111111